011111111111111111111110
2___0_____1_________0__2
2_0___0_0__0__0__0_____2
2_____0_0000000_0___0__2
2_____2_07_5_60_2_0____2
01111_2_0_535_0_2_111110
2_____2_0__5__0_2______2
2_2___2_000_000_2____2_2
2_2___2_________2____2_2
2429552_0111110_255_82_2
0101111101111101101110S0