011111111111111111111110
24______________8______2
2_1111101111111111111510
2______2____5_______1_02
2___2_______2_____261__2
011101111_050111111100_2
25__2_____2_2____2___2_2
25__2__1112_2___101__2_2
25__2_____2_2____2___2_2
25_____2_7232__0_2_0_292
0111111111010111111110S0