011111111011111111111110
23______82___9__4__5___2
0____11052______2__5___2
2________2______2__5___2
2________2__76__2______S
2_______________01111112
2_11111110______5______2
2________2______2______2
2___555__0111_1105011_12
2________5________5____2
011111111011111111111110          