011111101111111111111110
23____52______________42
011111_011111_11121111_0
2______2_________2_____2
2_1011_0111_111_121_1_12
2______5________62_____2
011111101111111110111170
2______2_______________2
2_251__2_5_211111_111112
S_291______25___8_____52
011111111110111111111110