011111111111111111111110
2_6_______3________7___2
2110_01110_0110_01111112
2__2_2___2_2__2_2______2
2______2____2__________2
011111105555501111111110
2______________________2
2________2____2________2
2________2____2____5___2
2___4____2_98_2____5___2
0111111111111111111S1110