011111111011111111111110
23//////82///9//4//5///2
0////11052//////2//5///2
2////////2//////2//5///2
2////////2//76//2//////S
2///////////////01111112
2/11111110//////5//////2
2////////2//////2//////2
2///555//0111/1105011/12
2////////5////////5////2
011111111011111111111110          